abate: (v.) to reduce in amount, degree, or severity
aberration: (n.) a departure from what is normal or expected
abhor: (v.) to hate deeply
abstain: (v.) to refrain from doing something
adversity: (n.) hardship or misfortune
aesthetic: (adj.) concerned with beauty or the appreciation of beauty
alacrity: (n.) brisk and cheerful readiness
ambiguous: (adj.) unclear or open to more than one interpretation
ameliorate: (v.) to improve or make better
anecdote: (n.) a short and amusing or interesting story about a real incident or person
antagonist: (n.) a person who actively opposes or is hostile to someone or something
arid: (adj.) extremely dry or lacking in interest
asylum: (n.) a place of refuge or safety
benevolent: (adj.) well-meaning and kindly
camaraderie: (n.) mutual trust and friendship among people who spend a lot of time together
censure: (v.) to criticize harshly
circuitous: (adj.) roundabout or not direct
clairvoyant: (adj.) able to see the future or having exceptional insight
collaborate: (v.) to work together on a common project
compassion: (n.) sympathetic pity and concern for the sufferings or misfortunes of others
compromise: (n./v.) an agreement or a settlement of a dispute that is reached by each side making concessions
condescending: (adj.) having or showing a feeling of patronizing superiority
conditional: (adj.) subject to one or more conditions or requirements being met
conformist: (n.) a person who conforms to accepted behavior or established practices
congregation: (n.) a group of people assembled for religious worship
consensus: (n.) general agreement among a group of people
convergence: (n.) the process or state of converging
deleterious: (adj.) causing harm or damage
demagogue: (n.) a political leader who seeks support by appealing to the desires and prejudices of ordinary people rather than by using rational argument
digression: (n.) a temporary departure from the main subject in speech or writing
diligent: (adj.) having or showing care and conscientiousness in one's work or duties
discredit: (v.) to harm the reputation of someone or something
disdain: (n./v.) the feeling that someone or something is unworthy of one's consideration or respect
divergent: (adj.) tending to be different or develop in different directions
empathy: (n.) the ability to understand and share the feelings of another
emulate: (v.) to match or surpass (a person or achievement), typically by imitation
enervating: (adj.) causing one to feel drained of energy or vitality
ephemeral: (adj.) lasting for a very short time
evanescent: (adj.) soon passing out of sight, memory, or existence
exemplary: (adj.) serving as a desirable model; representing the best of its kind
extenuating: (adj.) (of a factor or situation) serving to lessen the seriousness of an offense
florid: (adj.) having a red or flushed complexion
fortuitous: (adj.) happening by a lucky chance
frugal: (adj.) sparing or economical with regard to money or food
hackneyed: (adj.) (of a phrase or idea) lacking significance through having been overused; unoriginal and trite
haughty: (adj.) arrogantly superior and disdainful
hedonist: (n.) a person who believes that the pursuit of pleasure is the most important thing in life
hypothesis: (n.) a supposition or proposed explanation made on the basis of limited evidence as a starting point for further investigation
impute: (v.) represent (something, especially something undesirable) as being done, caused, or possessed by someone; attribute
incompatible: (adj.) (of two things) so opposed in character as to be incapable of existing together
inconsequential: (adj.) not important or significant
inevitable: (adj.) certain to happen; unavoidable
intrepid: (adj.) fearless; adventurous
intuitive: (adj.) using or based on what one feels to be true even without conscious reasoning; instinctive
jubilation: (n.) a feeling of great happiness and triumph
lobbyist: (n.) a person who takes part in an organized attempt to influence legislators
longevity: (n.) long life or existence
mundane: (adj.) lacking interest or excitement; dull
nonchalant: (adj.) (of a person or manner) feeling or appearing casually calm and relaxed; not displaying anxiety, interest, or enthusiasm
novice: (n.) a person new to or inexperienced in a field or situation
opulent: (adj.) ostentatiously rich and luxurious or lavish
orator: (n.) a public speaker, especially one who is eloquent or skilled
ostentatious: (adj.) characterized by vulgar or pretentious display; designed to impress or attract notice
parched: (adj.) dried out with heat
perfidious: (adj.) deceitful and untrustworthy
precocious: (adj.) (of a child) having developed certain abilities or proclivities at an earlier age than usual
pretentious: (adj.) attempting to impress by affecting greater importance, talent, culture, etc., than is actually possessed
procrastinate: (v.) delay or postpone action; put off doing something
prosaic: (adj.) having the style or diction of prose; lacking poetic beauty
prosperity: (n.) the state of being prosperous
prudent: (adj.) acting with or showing care and thought for the future
querulous: (adj.) complaining in a petulant or whining manner
rancorous: (adj.) characterized by bitterness or resentment
reclusive: (adj.) avoiding the company of other people; solitary
reconciliation: (n.) the restoration of friendly relations
renovation: (n.) the action of renovating a building
resilient: (adj.) (of a person or animal) able to withstand or recover quickly from difficult conditions
restrained: (adj.) characterized by reserve or moderation; unemotional or dispassionate
reverence: (n.) deep respect for someone or something
sagacity: (n.) the quality of being sagacious; having or showing keen mental discernment and good judgment
scrutinize: (v.) examine or inspect closely and thoroughly
spontaneity: (n.) the condition of being spontaneous; spontaneous behavior or action
spurious: (adj.) not being what it purports to be; false or fake
substantiate: (v.) provide evidence to support or prove the truth of
subtle: (adj.) (especially of a change or distinction) so delicate or precise as to be difficult to analyze or describe
superficial: (adj.) existing or occurring at or on the surface
superfluous: (adj.) unnecessary, especially through being more than enough
suppress: (v.) forcibly put an end to
surreptitious: (adj.) kept secret, especially because it would not be approved of
tactful: (adj.) having or showing tact
tenacious: (adj.) tending to keep a firm hold of something; clinging or adhering closely
transient: (adj.) lasting only for a short time; impermanent
venerable: (adj.) accorded a great deal of respect, especially because of age, wisdom, or character
vindicate: (v.) clear (someone) of blame or suspicion
wary: (adj.)feeling or showing caution about possible dangers or problems
zealous: (adj.) having or showing zeal
zealot: (n.) a person who is fanatical and uncompromising in pursuit of their religious, political, or other ideals
accolade: (n.) an award or privilege granted as a special honor or as an acknowledgment of merit
advocate: (v.) publicly recommend or support
aesthetic: (adj.) concerned with beauty or the appreciation of beauty